21111111111111111111111111111112
2..............................2
2..............................2
2..............................2
2..............................2
2..............................2
2..............................2
2..............................2
2..............................2
2..............................2
2..............................2
2..............................2
2..............................2
2..............................2
2...............P..............2
2..............................2
2..............................2
2..............................2
2..............................2
2..............................2
2..............................2
2..............................2
2..............................2
2..............................2
2...............M..............2
2..............................2
2..............................2
2..............................2
2..............................2
2..............................2
2..............................2
11111111111111111111111111111111